"Address A","Port A","Address B","Port B","Packets","Bytes","Packets A → B","Bytes A → B","Packets B → A","Bytes B → A","Rel Start","Duration","Bits/s A → B","Bits/s B → A",Target
"64.207.204.168",4287,"192.168.0.101",61894,2,170,1,104,1,66,57.18174,0.00015799999999899228,0,0,0
"67.222.248.107",4287,"192.168.0.101",61891,2,170,1,104,1,66,9.686388,0.00010699999999985721,0,0,0
"104.199.240.237",4070,"192.168.0.101",61201,4,680,2,548,2,132,35.549272,10.556610999999997,415.2847916817245,100.03210310581684,0
"192.168.0.101",62447,"192.111.4.103",443,23,5304,14,3674,9,1630,0,32.458935,905.5133817545154,401.7383811267992,0
"192.168.0.101",62308,"31.13.79.63",443,36,2916,18,1476,18,1440,0.026879,88.34360000000001,133.65993688280756,130.3999384222513,0
"192.168.0.101",62449,"40.77.226.250",443,25,12432,16,7676,9,4756,4.1794,0.8471529999999996,72487.49635543996,44912.78434946228,0
"192.168.0.101",62450,"142.250.66.4",443,14,2399,8,1175,6,1224,4.542592,0.19157199999999985,49067.71344455352,51113.94149458171,0
"192.168.0.101",62451,"142.250.66.4",443,31,4755,16,2444,15,2311,4.542884,45.407982,430.58508964349045,407.1530859926786,0
"192.168.0.101",62428,"35.186.224.25",443,66,11910,30,5108,36,6802,6.891699,74.688603,547.1249743418015,728.5716670855392,0
"192.168.0.101",58720,"34.68.219.28",5986,143,124225,61,35689,82,88536,8.066087,80.87376400000001,3530.3414343370982,8757.94528371401,0
"192.168.0.101",62060,"13.67.9.5",443,3,174,1,54,2,120,8.146252,37.851929999999996,11.412892288451344,25.361982863225208,0
"192.168.0.101",61398,"31.13.79.53",443,16,1437,8,748,8,689,8.51709,67.060411,89.23297532429379,82.19454545245779,0
"192.168.0.101",62452,"142.250.67.174",443,29,5224,15,2990,14,2234,9.609023,45.335437999999996,527.6225631701187,394.216992014062,0
"192.168.0.101",62453,"142.250.192.14",443,1271,1583038,186,15062,1085,1567976,10.003479,45.909715,2624.6296671630394,273227.74711191305,0
"192.168.0.101",62454,"172.217.27.214",443,28,8702,16,2275,12,6427,10.432979,45.278710000000004,401.9549143515793,1135.544718478066,0
"192.168.0.101",62455,"173.36.111.168",443,36,19685,22,11919,14,7766,10.459734,60.80088000000001,1568.26677508615,1021.8273156572733,0
"192.168.0.101",62456,"173.36.111.168",443,23,7750,12,1435,11,6315,10.620519999999999,60.947674000000006,188.35829567507366,828.907761106683,0
"192.168.0.101",62457,"173.36.111.168",443,25,11477,13,3145,12,8332,11.593766,59.996432,419.35827117185903,1110.9994007643654,0
"192.168.0.101",62458,"142.250.183.170",443,33,10846,14,2218,19,8628,11.668339,45.341262,391.3433199102398,1522.321985656244,0
"192.168.0.101",62440,"142.250.77.42",443,28,3974,12,2099,16,1875,11.73104,61.463525999999995,273.20267958593854,244.0471768573772,0
"192.168.0.101",62459,"173.36.111.168",443,22,8300,11,1369,11,6931,11.799689,60.557737,180.85220060320285,915.6220616368145,0
"192.168.0.101",62460,"142.251.42.45",443,91,55550,41,4203,50,51347,12.081946,45.439358,739.9752434882553,9040.092511870436,0
"192.168.0.101",62462,"142.250.199.131",443,42,20936,19,2529,23,18407,13.070363,45.239081,447.22393896551523,3255.061702071269,0
"192.168.0.101",62463,"172.217.174.66",443,31,9642,15,2251,16,7391,13.80025,45.392106,396.72096289165347,1302.6053472821905,0
"192.168.0.101",62464,"172.217.166.170",443,32,9079,14,2040,18,7039,14.211044,45.437498,359.17470631855656,1239.3288028315292,0
"192.168.0.101",62465,"142.250.183.131",443,514,584597,116,9419,398,575178,14.743106000000001,45.523262,1655.2416652391912,101078.52113058155,0
"192.168.0.101",62466,"142.250.183.131",443,16,5885,8,1009,8,4876,14.811168,0.13246099999999927,60938.691388408995,294486.6790980003,0
"192.168.0.101",62467,"142.250.183.131",443,13,5711,6,901,7,4810,14.811972,0.12331899999999862,58450.036085275424,312036.2636738899,0
"192.168.0.101",62468,"142.250.183.131",443,13,5710,6,901,7,4809,14.812823999999999,0.13479700000000072,53473.000140952405,285406.9452584241,0
"192.168.0.101",62469,"142.250.192.97",443,21,10078,11,1307,10,8771,14.844108,0.17676799999999915,59150.97755249847,396949.6741491692,0
"192.168.0.101",62470,"142.250.192.97",443,103,61817,51,5698,52,56119,14.845146,54.437959000000006,837.3568891515569,8247.039533572519,0
"192.168.0.101",62471,"142.250.192.97",443,21,10065,10,1229,11,8836,14.845584,0.1749419999999997,56201.48392038514,404065.34737227263,0
"192.168.0.101",62472,"142.250.192.97",443,24,10252,13,1415,11,8837,14.846148,0.19415700000000058,58303.33183969657,364117.69856353255,0
"192.168.0.101",62473,"142.250.192.97",443,22,10132,11,1295,11,8837,14.846619,0.18334699999999948,56504.87872722231,385585.80178568617,0
"192.168.0.101",62474,"142.250.192.97",443,20,10019,10,1241,10,8778,14.846924,0.1842220000000001,53891.500472256266,381192.2571679819,0
"192.168.0.101",62475,"142.250.183.36",443,32,9747,15,2433,17,7314,15.340218,45.432235,428.41828054463974,1287.8961380614448,0
"192.168.0.101",62476,"172.217.166.35",443,32,9529,15,2424,17,7105,15.389069,45.703878,424.29659907634095,1243.658142094638,0
"192.168.0.101",62477,"172.217.166.38",443,30,9063,15,2223,15,6840,16.942361,45.399084,391.725965219915,1205.310662215123,0
"192.168.0.101",62478,"216.58.196.67",80,10,1748,6,764,4,984,17.140755,60.045998,101.78863210833802,131.09949475733586,0
"192.168.0.101",62479,"142.250.76.174",443,34,12253,16,2319,18,9934,17.478348,45.370284,408.90200290569044,1751.6310896356745,0
"192.168.0.101",62415,"35.186.224.13",443,4,240,2,108,2,132,17.999356,45.168587,19.128338019517855,23.379079801632933,0
"192.168.0.101",62480,"40.77.226.250",443,24,12294,15,7538,9,4756,19.306563,0.9136179999999996,66005.70479128041,41645.41416653351,0
"192.168.0.101",62435,"13.35.205.168",443,4,240,2,108,2,132,23.514447,45.040492,19.18273894521401,23.44556982192823,0
"192.168.0.101",62481,"43.228.93.177",443,18,8265,9,1955,9,6310,23.530077,45.090629,346.8569932790248,1119.523083166571,0
"192.168.0.101",58729,"35.186.224.39",443,14,1735,7,591,7,1144,25.282825,61.40057899999999,77.00253119762927,149.05396901876122,0
"192.168.0.101",62482,"142.250.192.66",443,46,24651,23,2683,23,21968,25.406963,45.325492,473.55249888958735,3877.3765544563753,0
"192.168.0.101",58721,"35.186.224.47",443,10,1361,5,400,5,961,25.418048,51.15736700000001,62.55208560675141,150.28138567022026,0
"192.168.0.101",62483,"40.77.226.250",443,24,12398,15,7642,9,4756,33.761078,0.8709100000000021,70197.8390419215,43687.63706927226,0
"192.168.0.101",62484,"142.251.42.66",443,31,10951,15,3976,16,6975,35.929868,45.34872300000001,701.4089459586326,1230.4646373394019,0
"192.168.0.101",61958,"35.81.198.46",443,4,240,2,108,2,132,38.003066,45.57389700000001,18.958220755183604,23.171158700779962,0
"192.168.0.101",58566,"74.125.68.188",5228,4,240,2,108,2,132,43.932569,45.239551000000006,19.09833278407206,23.342406736088073,0
"192.168.0.101",62486,"40.77.226.250",443,26,12513,16,7703,10,4810,48.668541,0.8434039999999996,73065.8142479761,45624.63540604505,0
"192.168.0.101",62487,"192.111.4.104",443,49,19302,29,9217,20,10085,50.192566,26.104496999999995,2824.6474161137835,3090.655223121136,0
"192.168.0.101",62488,"23.213.180.59",443,444,540023,83,7070,361,532953,50.888545,1.5255679999999998,37074.7157779922,2794778.076100181,0
"192.168.0.101",62489,"17.111.103.26",443,27,8768,14,2990,13,5778,51.39078,31.654867000000003,755.6499921481268,1460.2493828200256,0
"192.168.0.101",62490,"23.212.161.210",443,23,9765,11,2217,12,7548,52.868016,0.4321079999999995,41045.29423199761,139742.84206726114,0
"192.168.0.101",62491,"23.212.161.210",443,25,10655,12,3032,13,7623,52.903624,0.43750999999999607,55441.01849100642,139388.81396996765,0
"192.168.0.101",62492,"23.212.161.210",443,26,10712,13,3098,13,7614,53.136118,0.37529099999999715,66039.42007668766,162306.0505048095,0
"192.168.0.101",62493,"40.77.226.250",443,23,11854,14,7098,9,4756,63.680602,0.9090670000000003,62464.042804325734,41853.90075758991,0
"192.168.0.101",62495,"40.77.226.250",443,23,11530,14,6774,9,4756,78.784702,0.9147600000000011,59241.76833267735,41593.42341160518,0
"192.168.0.101",62496,"13.35.210.16",443,23,9742,9,1442,14,8300,79.391059,0.26920599999999695,42851.94237869933,246651.26334480193,0
"192.168.0.101",58366,"142.250.67.202",443,51,5550,24,3013,27,2537,1.095701,85.388983,282.28465960298416,237.6887425863826,0
"192.168.0.101",49717,"172.217.167.174",443,70,40588,44,35801,26,4787,1.121416,24.128532,11870.0963655808,1587.1665959619922,0
"192.168.0.101",50418,"142.250.66.14",443,95,49169,60,43792,35,5377,1.124401,78.66100999999999,4453.743983200827,546.8528817517091,0
"192.168.0.101",52144,"142.250.183.36",443,69,48401,26,2962,43,45439,4.290454,0.404261,58615.59734923725,899201.2585928398,0
"192.168.0.101",50230,"208.67.222.222",443,2,520,1,302,1,218,4.435703,0.10356399999999955,23328.569773280393,16839.828511838165,0
"192.168.0.101",56817,"192.168.0.1",53,2,158,1,79,1,79,6.925996,0.00419700000000045,0,0,0
"192.168.0.101",61182,"192.168.0.1",53,2,165,1,88,1,77,6.937545,0.03418800000000033,20592.020592020395,18018.018018017843,0
"192.168.0.101",64192,"142.251.42.10",443,8,883,4,550,4,333,6.940543,0.3882979999999998,11331.50312388939,6860.710073191212,0
"192.168.0.101",62816,"208.67.222.222",443,2,1069,1,366,1,703,6.978275,0.03200000000000003,91499.99999999991,175749.99999999985,0
"192.168.0.101",60316,"208.67.222.222",443,2,712,1,366,1,346,9.494477,0.11149900000000024,26260.3252047103,24825.334756365475,0
"192.168.0.101",57469,"192.168.0.1",53,2,198,1,77,1,121,9.881321,0.5757650000000005,1069.8809410089175,1681.2414787282992,0
"192.168.0.101",52002,"208.67.222.222",443,2,968,1,366,1,602,9.883833,0.11326100000000139,25851.79364476708,42521.25621352399,0
"192.168.0.101",51923,"208.67.222.222",443,2,900,1,426,1,474,10.393049,0.03376800000000024,100923.9516702196,112295.6645344697,0
"192.168.0.101",54152,"208.67.222.222",443,2,712,1,366,1,346,10.614562,0.11147400000000118,26266.2145433013,24830.902273175543,0
"192.168.0.101",64855,"208.67.222.222",443,2,584,1,302,1,282,10.92011,0.106993000000001,22580.916508556424,21085.49157421494,0
"192.168.0.101",51274,"208.67.222.222",443,2,584,1,366,1,218,11.29406,0.030281999999999698,96691.10362591736,57591.96882636607,0
"192.168.0.101",59384,"192.168.0.1",53,2,214,1,83,1,131,11.304038,0.287191,2312.0501687030583,3649.139422892779,0
"192.168.0.101",49997,"208.67.222.222",443,2,665,1,302,1,363,11.555229,0.10997899999999916,21967.830222133485,26405.040962365743,0
"192.168.0.101",60716,"208.67.222.222",443,2,584,1,366,1,218,11.968901,0.10914099999999927,26827.68162285502,15979.329491208728,0
"192.168.0.101",60717,"208.67.222.222",443,2,648,1,366,1,282,13.029602,0.03708999999999918,78943.11135077015,60825.02022108519,0
"192.168.0.101",50501,"208.67.222.222",443,2,776,1,430,1,346,13.682324,0.11265900000000073,30534.622178432062,24569.719241249986,0
"192.168.0.101",62947,"208.67.222.222",443,2,712,1,430,1,282,14.098604,0.10674299999999981,32226.937597781645,21134.875354824242,0
"192.168.0.101",59418,"208.67.222.222",443,2,743,1,366,1,377,14.808895,0.02990100000000062,97923.14638306208,100866.19176615957,0
"192.168.0.101",65487,"208.67.222.222",443,2,648,1,430,1,218,15.34942,0.03011199999999903,114240.17003188467,57917.10945802525,0
"192.168.0.101",49240,"208.67.222.222",443,2,648,1,302,1,346,16.83123,0.107880999999999,22395.046393711797,25657.90083517974,0
"192.168.0.101",53891,"192.168.0.1",53,2,158,1,79,1,79,17.088824,0.0022800000000025022,0,0,0
"192.168.0.101",59217,"192.168.0.1",53,2,165,1,88,1,77,17.096435,0.034393999999998925,20468.686398791127,17910.100598942234,0
"192.168.0.101",61359,"208.67.222.222",443,2,520,1,238,1,282,17.118181,0.03592300000000037,53002.25482281492,62800.99100854541,0
"192.168.0.101",55648,"208.67.222.222",443,2,904,1,238,1,666,17.139005,0.03648600000000002,52184.399495696955,146028.61371484946,0
"192.168.0.101",54083,"208.67.222.222",443,2,648,1,302,1,346,17.369444,0.10573999999999728,22848.49631170855,26177.41630414291,0
"192.168.0.101",56349,"208.67.222.222",443,2,629,1,238,1,391,18.099375,0.08938800000000313,21300.398263748302,34993.51143330078,0
"192.168.0.101",50942,"208.67.222.222",443,2,456,1,238,1,218,18.362431,0.030101999999999407,63251.611188626586,57936.349744204184,0
"192.168.0.101",51472,"208.67.222.222",443,2,776,1,430,1,346,19.245709,0.057710999999997625,59607.3538840107,47963.12661364582,0
"192.168.0.101",57160,"208.67.222.222",443,2,840,1,430,1,410,23.418065,0.10799200000000297,31854.2114230675,30372.620194087613,0
"192.168.0.101",53393,"208.67.222.222",443,2,648,1,366,1,282,23.983093,0.030173000000001338,97040.4003579316,74768.83306266861,0
"192.168.0.101",51991,"208.67.222.222",443,2,840,1,430,1,410,25.053664,0.033362000000000336,103111.32426113439,98315.44871410487,0
"192.168.0.101",62992,"208.67.222.222",443,2,712,1,366,1,346,25.277217,0.1145700000000005,25556.42838439371,24159.902243170007,0
"192.168.0.101",63956,"192.168.0.1",53,2,158,1,79,1,79,27.254493,0.0025049999999993133,0,0,0
"192.168.0.101",57549,"192.168.0.1",53,2,165,1,88,1,77,27.274045,0.03672899999999757,19167.415393831758,16771.488469602788,0
"192.168.0.101",56150,"208.67.222.222",443,2,968,1,302,1,666,27.318241,0.033799999999999386,71479.2899408297,157633.1360946774,0
"192.168.0.101",57621,"192.168.0.255",57621,3,258,3,258,0,0,27.596021,60.006784,34.396110946388994,0,0
"192.168.0.101",55896,"208.67.222.222",443,2,776,1,430,1,346,35.811594,0.11186500000000166,30751.352076162777,24744.11120547051,0
"192.168.0.101",51165,"192.168.0.1",53,2,158,1,79,1,79,37.439895,0.009062000000000126,69741.77885676354,69741.77885676354,0
"192.168.0.101",62680,"192.168.0.1",53,2,165,1,88,1,77,37.455953,0.02995899999999807,23498.781668281496,20561.433959746308,0
"192.168.0.101",56250,"208.67.222.222",443,2,840,1,238,1,602,37.494381,0.03056200000000331,62299.58772330979,157581.31012366596,0
"192.168.0.101",63748,"208.67.222.222",443,2,776,1,430,1,346,44.834699,0.1881350000000026,18284.742339277393,14712.839184627856,0
"192.168.0.101",62195,"239.255.255.250",1900,4,864,4,864,0,0,46.717041,3.000622,2303.5224030217737,0,0
"192.168.0.101",49768,"192.168.0.1",53,2,158,1,79,1,79,47.537151,0.009537999999999158,66261.27070665294,66261.27070665294,0
"192.168.0.101",63894,"192.168.0.1",53,2,165,1,88,1,77,47.555522,0.0477289999999968,14749.942383038555,12906.199585158734,0
"192.168.0.101",56061,"208.67.222.222",443,2,776,1,238,1,538,47.616605,0.05660000000000309,33639.57597172961,76042.40282685097,0
"192.168.0.101",57880,"208.67.222.222",443,2,776,1,430,1,346,48.628496,0.035637999999998726,96526.17992031323,77669.90291262414,0
"192.168.0.101",56970,"192.168.0.1",53,2,444,1,86,1,358,50.150096,0.03451400000000149,19933.939850494593,82980.81937764028,0
"192.168.0.101",52458,"208.67.222.222",443,2,726,1,444,1,282,50.504089,0.10663399999999967,33310.201249132646,21156.47917174641,0
"192.168.0.101",53116,"208.67.222.222",443,2,645,1,302,1,343,50.841106,0.03041499999999786,79434.48956107743,90218.64211738264,0
"192.168.0.101",63365,"192.168.0.1",53,2,168,1,76,1,92,51.198002,0.10086700000000093,6027.739498547537,7296.737287715439,0
"192.168.0.101",51442,"208.67.222.222",443,2,643,1,302,1,341,51.348046,0.03765200000000135,64166.57813661727,72452.99054498837,0
"192.168.0.101",58747,"208.67.222.222",443,2,712,1,302,1,410,51.879052,0.0731970000000004,33006.81721928476,44810.579668565406,0
"192.168.0.101",64157,"208.67.222.222",443,2,776,1,430,1,346,52.13333,0.029916000000000054,114988.6348442303,92525.73873512485,0
"192.168.0.101",51390,"208.67.222.222",443,2,775,1,429,1,346,52.406165,0.09202499999999958,37294.21352893252,30078.782939418772,0
"192.168.0.101",54502,"208.67.222.222",443,2,520,1,302,1,218,52.713156,0.039054000000000144,61863.061402160885,44656.117171096266,0
"192.168.0.101",55886,"208.67.222.222",443,2,392,1,238,1,154,52.99237,0.03044299999999822,62543.113359396615,40469.07335019781,0
"192.168.0.101",62313,"239.255.255.250",1900,4,848,4,848,0,0,53.641546,2.998997000000003,2262.089625298056,0,0
"192.168.0.101",57537,"208.67.222.222",443,2,837,1,427,1,410,53.820539,0.06269900000000206,54482.52763201786,52313.4340260593,0
"192.168.0.101",57797,"208.67.222.222",443,2,520,1,302,1,218,54.001338,0.0335980000000049,71909.04220488266,51907.851657829204,0
"192.168.0.101",51572,"192.168.0.1",53,2,158,1,79,1,79,57.706239,0.0035140000000026816,0,0,0
"192.168.0.101",60788,"192.168.0.1",53,2,165,1,88,1,77,57.717559,0.03731099999999543,18868.43022165276,16509.876443946167,0
"192.168.0.101",58993,"208.67.222.222",443,2,904,1,366,1,538,57.763949,0.03386600000000328,86458.39485028395,127089.11592746657,0
"192.168.0.101",50626,"192.168.0.1",53,2,158,1,79,1,79,67.875358,0.010036999999996965,62967.02201855047,62967.02201855047,0
"192.168.0.101",58055,"192.168.0.1",53,2,165,1,88,1,77,67.8982,0.03167999999999438,22222.222222226166,19444.444444447894,0
"192.168.0.101",64785,"208.67.222.222",443,2,840,1,302,1,538,67.942116,0.03416800000000819,70709.43572932044,125965.81596812714,0
"192.168.0.101",49624,"208.67.222.222",443,2,648,1,302,1,346,69.580343,0.08950300000000766,26993.50859747487,30926.33766465664,0
"192.168.0.101",5353,"224.0.0.251",5353,2,234,2,234,0,0,77.257854,1.2000000012335477e-05,0,0,0
"192.168.0.101",55649,"192.168.0.1",53,2,158,1,79,1,79,78.216113,0.006860999999986461,92114.85206256334,92114.85206256334,0
"192.168.0.101",62260,"192.168.0.1",53,2,165,1,88,1,77,78.259464,0.04220600000000729,16680.092877787007,14595.08126806363,0
"192.168.0.101",65235,"208.67.222.222",443,2,840,1,302,1,538,78.341113,0.03321099999999433,72746.9814218305,129595.61591041327,0
"192.168.0.101",51157,"192.168.0.1",53,2,156,1,78,1,78,79.315314,0.047809999999998354,13051.662832043954,13051.662832043954,0
"192.168.0.101",57131,"192.168.0.1",53,2,220,1,78,1,142,79.315548,0.06971099999999808,8951.241554417771,16295.850009324658,0
"192.168.0.101",62037,"192.168.0.1",53,2,158,1,79,1,79,88.489602,0.030846999999994296,20488.21603397792,20488.21603397792,0
"192.168.0.101",52954,"192.168.0.1",53,2,165,1,88,1,77,89.00782,0.034771000000006325,20246.75735526364,17715.912685855685,0
"192.168.0.101",55862,"208.67.222.222",443,2,776,1,238,1,538,89.240873,0.03394900000000689,56084.126189272545,126778.40289843961,0
"fe80::8be:62a0:772e:a921",5353,"ff02::fb",5353,2,274,2,274,0,0,77.281719,5.5000000003246896e-05,0,0,0
"192.168.0.101",64666,"142.250.199.138",443,18,7779,8,2718,10,5061,4.531731,1.2598140000000004,17259.690716248584,32138.07752572998,1
"192.168.0.101",60752,"142.250.192.14",443,1940,1656859,663,425909,1277,1230950,10.385498,78.138225,43605.70002709941,126027.94598930293,1
"192.168.0.101",55701,"142.250.183.110",443,35,23619,15,4060,20,19559,10.731969,0.5410339999999998,60033.19569564946,289209.18093872117,1
"192.168.0.101",55862,"142.251.42.46",443,24,11176,11,6239,13,4937,11.03162,0.5221339999999994,95592.31921307568,75643.41720707719,1
"192.168.0.101",53898,"142.250.199.131",443,10,5133,5,1683,5,3450,11.288107,0.14928399999999975,90190.50936470099,184882.50582781842,1
"192.168.0.101",55063,"142.250.183.131",443,10,5135,5,1685,5,3450,11.331702,0.16136200000000045,83538.87532380587,171043.98805170934,1
"192.168.0.101",57685,"142.250.192.14",443,19,8732,10,4112,9,4620,14.079039999999999,0.5367910000000009,61282.69661749162,68853.61341751248,1
"192.168.0.101",58722,"172.217.174.66",443,20,11154,9,3737,11,7417,14.113419,0.2474109999999996,120835.37110314435,239827.65519722283,1
"192.168.0.101",50833,"142.250.183.110",443,19,8085,9,3816,10,4269,14.597228,1.8360509999999994,16626.989119583286,18600.790500917465,1
"192.168.0.101",50139,"142.250.199.131",443,82,62195,30,5529,52,56666,14.788111,0.2029999999999994,217891.62561576418,2233142.857142864,1
"192.168.0.101",55832,"172.217.27.214",443,1658,1696019,269,29185,1389,1666834,14.794281,59.28955500000001,3937.961753971673,224907.6080938708,1
"192.168.0.101",58969,"142.250.192.97",443,154,97584,60,9262,94,88322,15.962155,10.381425,7137.363126931033,68061.56187613936,1
"192.168.0.101",53887,"142.250.183.131",443,297,281196,73,8938,224,272258,16.81117,48.291037,1480.688849154347,45102.86246286241,1
"192.168.0.101",50719,"142.250.183.170",443,28,12919,12,4440,16,8479,17.23287,0.3235050000000008,109797.37562016015,209678.36664039144,1
"192.168.0.101",54027,"43.228.93.177",443,17877,20521320,2054,188091,15823,20333229,23.803137,51.729277,29088.51790060781,3144560.3231609054,1
"192.168.0.101",53354,"43.228.93.13",443,3503,4004898,389,40705,3114,3964193,25.095105,10.001690999999997,32558.49435860397,3170818.2146399054,1
"192.168.0.101",49320,"142.250.192.66",443,24,12050,11,4791,13,7259,26.642287,0.3210230000000003,119393.31449771501,180896.69587537326,1
"192.168.0.101",53357,"142.250.199.138",443,19,9007,8,3883,11,5124,39.098523,0.588039000000002,52826.42817908318,69709.66211424729,1
"192.168.0.101",60103,"142.250.183.36",443,10,6303,5,2853,5,3450,40.141737,0.1620360000000005,140857.58720284337,170332.5186995477,1
"192.168.0.101",65134,"142.250.183.36",443,10,6304,5,2854,5,3450,40.144914,0.1597629999999981,142911.6879377595,172755.89466898047,1
"192.168.0.101",50395,"142.250.183.36",443,44,27467,19,4690,25,22777,41.335151,24.549584000000003,1528.3354699615275,7422.366097934693,1
"192.168.0.101",62247,"142.250.76.170",443,25,7255,12,2937,13,4318,45.028547,21.805982999999998,1077.5024450858282,1584.152386067622,1
"192.168.0.101",54032,"142.250.192.14",443,18,8717,9,4067,9,4650,45.347446,0.5316510000000036,61198.04157238447,69970.71387056498,1
"192.168.0.101",55539,"142.250.183.110",443,22,10734,10,5108,12,5626,45.876237,30.911363999999992,1321.9733687584933,1456.0340980100398,1
"192.168.0.101",63728,"142.250.199.131",443,17,6120,8,2217,9,3903,50.616639,0.3612180000000009,49100.54316230075,86440.87503944965,1
"192.168.0.101",52436,"142.250.199.131",443,30,7921,14,2988,16,4933,59.445761,28.290275,844.9546708188591,1394.9669983766505,1
"192.168.0.101",52168,"172.217.174.66",443,58,13231,28,6508,30,6723,61.369583,21.246523000000003,2450.4715430378888,2531.4259655568108,1
"192.168.0.101",60309,"142.250.192.97",443,170,115663,65,8642,105,107021,64.824639,17.71785,3902.0535787355693,48322.34159336489,1
"192.168.0.101",49400,"172.217.166.35",443,21,10855,10,3973,11,6882,65.426327,0.2542720000000003,124999.99999999987,216524.03725144704,1
"192.168.0.101",63446,"172.217.167.174",443,26,14751,13,8525,13,6226,69.104448,0.4224309999999889,161446.48475136008,117908.01337970298,1
"192.168.0.101",62752,"202.65.141.13",443,40427,47010939,4228,354061,36199,46656878,69.68613,19.922457999999992,142175.6291317066,18735390.181271818,1
"192.168.0.101",49734,"142.250.199.131",443,23,15968,10,3744,13,12224,73.755155,0.155982999999992,192020.92535726033,626940.1152690038,1
"192.168.0.101",64189,"142.250.192.14",443,18,10051,9,5206,9,4845,76.190557,0.5262929999999955,79134.6265293294,73647.188923281,1